111111111111111
101P10000101001
1C0001011000101
110100001010101
101101100E10101
10C000C01010101
101111101111101
100100000000001
11C111111111111
100010000010101
111010101011001
100010101010101
101111101010101
100000001000101
111111111111111