111111111111111
101P10000101001
100001011000101
110100C01010101
101101100E10101
10C000001010101
1C1111101111101
100100000000001
110111111111111
100010000010101
111010101011001
100010101010101
101111101010101
100000001000101
111111111111111