111111111111111
101310000101001
100001011000101
110140001010101
101101100010101
100000001010101
101111101111101
100100000000001
110111111111111
100010000010101
111010101015001
100010101010101
101111101010101
100000001000101
111111111111111