111111111111111
101P10000101001
100001011000101
110100001010101
1011C1100E10101
1C0000001010101
101111101111101
10010000000000111
11C111111111111
100010000010101
111010101011001
100010101010101
1000000010001
111111111111111